111111111111111111111
1E0000000000000000001
1000CCC00CC000CC00001
1000C000C0000C0000001
1000CC00C0CC0C0CC0001
1000C000C00C0C00C0001
1000CCC00CCC00CCC0001
1000000000000000000P1
111111111111111111111
