111111111111111111111
1EC000000000000000001
100011100110001100001
100010001000010000001
100011001011010110001
100010001001010010001
100011100111001110001
1000000000000000000P1
111111111111111111111
